{
    "width": 7,
    "height": 7,
    "grid": [
        "S######",
        "#######",
        "###B###",
        "###X###",
        "###X###",
        "###P###",
        "#######"
    ]
}