{
    "width": 9,
    "height": 9,
    "grid": [
        "S########",
        "####X####",
        "####B####",
        "#########",
        "####b####",
        "####X####",
        "####X####",
        "####P####",
        "#########"
    ]
}