{
    "width": 11,
    "height": 11,
    "grid": [
        "S##########",
        "#####X#####",
        "#####B#####",
        "###########",
        "##v#####b##",
        "##X#####X##",
        "##X#####X##",
        "###########",
        "#####C#####",
        "#####X#####",
        "#####P#####"
    ]
}