{
    "width": 10,
    "height": 10,
    "grid": [
        "S####......",
        "#####......",
        "#####......",
        "#####......",
        "#####......",
        "...........",
        "...........",
        "...........",
        "...........",
        "..........."
    ]
}