{
    "width": 10,
    "height": 10,
    "grid": [
        "S####.....",
        "#####.....",
        "##B######P",
        "#####.....",
        "#####.....",
        "..#.......",
        "..#.......",
        "..#.......",
        "..#.......",
        "..P......."
    ]
}