{
    "width": 9,
    "height": 9,
    "grid": [
        "#########",
        "#########",
        "#.B###P.#",
        "#########",
        "#.b#S#p.#",
        "#########",
        "#.v###w.#",
        "#########",
        "#########"
    ]
}