{
    "width": 7,
    "height": 7,
    "grid": [
        "#######",
        "###S###",
        "#######",
        ".#...#.",
        ".b...B.",
        ".#...#.",
        ".P###p."
    ]
}